################################################################
#..............................................................#
#....#..........................................#........#.....#
#......#........................................................#
#..............................................................#
#........................#.............................#......#
#..#..............#.........................#....................#
#.........................................#........#.............#
#......................#........................................#
#...................................#...........................#
#...............#...............................................#
#...................................................#...........#
#............................#.................................#
#....#........#................#.#.#.............................#
#......#.........................@..............................#
#..............................#.#.#...........................#
#...........#...................................................#
#..............................................................#
#.....................#.........................................#
#...................................................#...........#
#..............................................................#
#........#...................#..............#.....................#
#..............................................................#
#..............................................................#
#.........................#.....................................#
#..............#.............................#...................#
#.......................#.......................................#
#.........................................#.....................#
#.......#.......................................................#
################################################################