...###
..##.#.####
.##..###..#
##........#
#...@..#..#
###..###..#
..#..#....#
.##.##.#.##
.#......##..#
.#.....##
.#######
####.........