############
#..........#
#..........#
#..........#
#..........#
#.....@....#
#..........#
#..........#
#..........#
#..........#
#..........#
############