......#.....
.....#.#....
....#...#...
............
....#####...
....#.@.#...
....#...#...
....#####...
............
.....#.#....
......#.....
.....#.#....